11111111
1PE10001
100001C1
11111111