11111111111111111111
10011101100001000011
11111CCCCCCCC1011001
1011100100C100C00001
110101001011000C0101
10000010000000000001
10000100000000001001
11010001000100000001
110000000000C0001101
100000100010001P0001
10000000010000000001
10000001100010C00001
10011000001010000001
11000100100010001001
100000000010000E0001
10010101100000100101
11000000110100100111
10000000000100C00001
100X0001001110000C01
11111111111111111111