1111111111111111111111111111111111111111
1101000010011100000000000100000000000001
1X10010100011000000000000011100100000001
1000100000000000000010000000000000011001
1111000001000100011000010000100000001001
1000000000010101010000000001000100000101
1000000010010000010C00001000000010010001
1000000000C00000101001011110100011110011
1111100001001000001000000000000010100001
1001000000000000100000000C00101000000001
1010000001000010010P00000100000000100011
1010000100000010000000100000100000000001
1100000010100000111110000001000000001001
1000000001000001010000100101110010001011
1000001010000000000000C00000000000101111
1100100011000000010000101000000101101001
1000010100111001010011000001001000010001
1100001000100010010011000100100000000011
1011010010100000100100010000001000000101
10100001001100000000000010C0001000011001
1000000001000000000001000000000000101001
1110010100010110000C11000000000010101111
1001001000001000000000010101110000001001
100010001000100000000000000E000C01000001
1000001000001000000000000110000101001101
1000000000000001010000100101100001000011
1100000C00001100110100111000000000001001
1010000001001000010100000000000100001101
1000000010001101000001100000100000000001
1000000010000000000110101100100001100011
1100011011001000000100010100011000000001
1100000000100000000000100000000000011011
1000000000C00110000010000010000001000101
1111111111111111111111111111111111111111