111111111111111111111111111111111111111111111111111111111111
111100010000000101100000000000000000000010010010000100100011
10000001100000000000000001001000000100010C0000E0000000000011
1000100011000000000000110000000000001000000000001000001010C1
100000000001001001000001011000100000100000000100100101101001
110001000111001000100010000001001001100100000010010000110001
101001010000000010000100000000000110000100000110010010001001
1000000C0000100101000000000000101010010000010010X00000010001
1010000000000000001010P0000100001101000100110001000000000001
110000000000011000110000101000000011011100010100000100000001
100000000001010011001000000001000100000000110000100010000011
101010110001000000000011000100000000010100000000100100001001
100001011000001000100001000001101000010000010001010000001001
100001001101000001100000000001000000000000000010000000000001
100010000000001000010000001000010000000000000000000100100001
100000000000000011000010000000000000000000000100000001000001
100010010000000010000000100100010000100001000000010011100111
100011000100000001000010100000000000010010100000001001011101
110000010010001100000110000000100000000000000000000000100001
101C00110000000000101000000000100001100110010000100001100011
100000000000000000000000010001010010100000100000110000010001
101011001000000010011000000001010000000000010000000000101001
100000001000000101000100010000000000010100010011000000000001
110010100001001001000001000000000000001101001100000101100001
100000000000000000011010000000000000000000000110000001000011
100000011001010000101001111000000001000100001000000000000001
100101010000000000000000010000000000000000100010000000110001
100000000011100000000001000010000010000000001000000000000001
100010000000100011000001100001100110000001100010000101000101
100001000110000000000001010010000000110000100000000000000001
100000000000000000011000001000000000000110000000000110100001
101100000000000000000010001000100101001000000000000000010111
100000111000000000010010000000001101000011000100000000001001
110000000011110000001100000101100010001101100000010100000001
110100100101000100000111110000000000010000010000000000010001
100000010000011000001000010000100100000100000000100000010001
1010100000000000000000001000100100000000C0000000000001000101
100000000010000000010000000000000000010001100000000000000001
100010000010000101000000001000100100000100100000000100010101
100000000001010001000010001000010001000001000100110000001001
100001100000001000000100100001110001000000010000000100010011
100010000010011000000010111000000000000000000101000100100001
100000100000000000100010011000000000101110001101000100001001
1000000000000000000101001000000000001101000000000C0000000001
101000000000010001000000000101010100000010010110C00001011001
1010100100010000000C0000000000000000000000010000000010011001
100010000000010000000000000011100000001010000100000000000011
100001010100000000001001000000010001010000000000000000000101
100010011000000000011000011100000000000100000000010000100101
10000000000010100001000000C100000100101101100000010110000001
100000000000000010000000000100001101000000000000100100100001
110000010000001001000101000000001000000001000000000111110C01
100000011000001000001000100101001110000100100010100000001001
100101010000000011000001010010000000000010100000001001000011
100000000100100000000000110100000000001000010100000000100001
100000010100000011010100000101000110000100000010110110100111
100001000001000000000000000100000000001100000100001000000101
100100100001000000010000000100000110000000000100001000000001
110000000000000000001000000101000100000000000010001000010001
111111111111111111111111111111111111111111111111111111111111



